-14
14
-9
9
1111111111110000000111111111
1111111110000000000000111111
1111111100000000000000001111
1111111000000000000000000111
1111100000000000000000000111
1100000000000000111100000011
1000000000000000111100000011
0000000000000001111110000011
0000000111000001111110000002
1000001111000001111110000002
1100001110000000111110000002
1122221110000000111100000002
1111111100000000111100000011
1111111100000000000000000011
1111111100000000000000000011
1111111100000000000000000111
1111111110000000000000001111
1111111111000011111000001111
