-8
16
-9
9
111000000000111111111111
100000000000000111111111
000000000000000000111111
000000000000000000110000
000000000000000000110000
100000001100000000100000
100000001111100000000000
100000001111110000000000
110000000111110000000001
110000000111111110000011
110000000111111110000011
110000000111111100000011
111000000000000000000011
111000000000000000000011
111000000000000000000111
111100000000000000001111
111100000000000000011111
111111110000111111111111
