-33
34
-24
42
0000011111111111111111111111111111111111111111111111111111111100000
0000011111111111111111111111111111111111111111111111111111111100000
0000011111111111111111111111111111111111111111111111111111111100000
0000001111111111111111111111111111111111111111111111111111111000000
0000000000000000000000000000000000000000000000000000000000000000000
1110000000000000000000000000000000000000000000000000000000000000111
1111000000000000000000000000000000000000000000000000000000000001111
1111000000000000000000000000000000000000000000000000000000000001111
1111000000000000000000000000000000000000000000000000000000000001111
1111000000000000000000000000000000000000000000000000000000000001111
1111000000000000000000000000000000000000000000000000000000000001111
1111000000000000000000000000000000000000000000000000000000000001111
1111000000000000000000000000000000000000000000000000000000000001111
1111000000000000000000000000000000000000000000000000000000000001111
1111000000000000000000000000000000000000000000000000000000000001111
1111000000000000000000000000000000000000000000000000000000000001111
1111000000000000000000001111000000000001111000000000000000000001111
1111000000000000000000001111000000000001111000000000000000000001111
1111000000000000000000001221000000000001221000000000000000000001111
1111000000000000000000000000000000000000000000000000000000000001111
1111000000000000000000000000000000000000000000000000000000000001111
1111000000000000000000000000000000000000000000000000000000000001111
1111000000000000000000000000000000000000000000000000000000000001111
1111000000000000000000000000000000000000000000000000000000000001111
1111000000000000000000000000000000000000000000000000000000000001111
1111000000000000000000000000000000000000000000000000000000000001111
1111000000000000000000000000000000000000000000000000000000000001111
1111000000000011110000011110000000000000111100000111100000000001111
1111000000000011110000011110000000000000111100000111100000000001111
1111000000000012210000011110000000000000111100000122100000000001111
1111000000000000000000000000001111111000000000000000000000000001111
1111000000000000000000000000001111111000000000000000000000000001111
1111000000000000000000000000001111111000000000000000000000000001111
1111000000000000000000000000001111111000000000000000000000000001111
1111000000000000000000011110001100011000000000000000000000000001111
1111000000000000000000011110000000000000111100000000000000000001111
1111000000000000000000011110000000000000111100000000000000000001111
1111000000000000000000000000000000000000000000000000000000000001111
1111000000000011110000000000000000000000000000000111100000000001111
1111000000000011110000000000000000000000000000000111100000000001111
1111000000000012210000000000000000000000000000000122100000000001111
1111000000000000000000000000000000000000000000000000000000000001111
1111000000000000000000000000000000000000000000000000000000000001111
1111000000000000000000000000000000000000000000000000000000000001111
1111000000000000000000000000000000000000000000000000000000000001111
1111000000000000000000000000000000000000000000000000000000000001111
1111000000000000000000000000000000000000000000000000000000000001111
1111000000000000000000000000000000000000000000000000000000000001111
1111000000000000000000000000000000000000000000000000000000000001111
1111000000000000000000001111000000000001111000000000000000000001111
1111000000000000000000001111000000000001111000000000000000000001111
1111000000000000000000001221000000000001221000000000000000000001111
1111000000000000000000000000000000000000000000000000000000000001111
1111000000000000000000000000000000000000000000000000000000000001111
1111000000000000000000000000000000000000000000000000000000000001111
1111000000000000000000000000000000000000000000000000000000000001111
1111000000000000000000000000000000000000000000000000000000000001111
1111000000000000000000000000000000000000000000000000000000000001111
1111000000000000000000000000000000000000000000000000000000000001111
1111000000000000000000000000000000000000000000000000000000000001111
1110000000000000000000000000000000000000000000000000000000000000111
0000000000000000000000000000000000000000000000000000000000000000000
0000000000000000000000000000000000000000000000000000000000000000000
0000000000000000000000000000000000000000000000000000000000000000000
0000011111111111111111111111111222221111111111111111111111111100000
0000011111111111111111111111111111111111111111111111111111111100000
