-11
11
-6
11
1111111111111112222111
1111111111111000000001
1111111111100000000000
1111111100000000000000
1111111000000000000000
1111110000000000000000
1111100000000000000000
1111000001100000000000
1110000011100000000000
1110000011100000000001
1100000000000000000001
1100000000000001100001
2000000000000001100011
2000000000000000000011
2000000000000000000011
2000000000000000000111
1100000000000001111111
