-9
11
-11
14
11111100000011111111
11110000000001111111
11110000000000011111
11000000000000001111
11000000000000001111
20000000000000000111
20000000000000000011
20000000011100000011
20000000011110000011
11000000011110000001
11100000001111000001
11100000001111000000
11100000001111000000
11110000000111000000
11111000000000000000
11111100000000000000
11111100000000000000
11111110000000000001
11111111000000000001
11111111100000000001
11111111110000000001
11111111110000000011
11111111111000000011
11111111111000000111
11111111111122221111
