8
65
-49
11
111111110000000001111100111111111111111111111111111111111
111111100000000000000000011111111111111111111111111111111
111111100000110000000000001111111111111111111111111111111
111111000000110000000000001111111111111111111111111111111
111111000000000000000000001111111111111111111111111111111
111111000000000000000000001111111111111111111111111111111
111111000000000000000000001111111111111111111111111111111
111111000000000011000000001111111111111111111111111111111
111111000000000011000100001111111111111111111111111111111
111111000000000111000110001111111111111111111111111111111
111111000000000111000110001111111111111111111111111111111
111111110000001111000010001111111111111111111111111111111
111111111000001110000000001111111111111111111111111111111
111111111000001100000000001111111111111111111111111111111
111111111100000000000000001111111111111111111111111111111
111111111100000000000000001111111111111111111111111111111
111111111000000000000000011111111111111111111111111111111
111111111000000000000000111111111111111111111111111111111
111111110000000011100000111111111111111111111111111111111
111111100000000111100000111111111111111111111111111111111
111111000000000111000000011111001111111111111111111111111
111111000000000110000000001110001111111111111111111111111
111111000000000110000000000000000011111111111111111111111
111111000000000000000000000000000011111111111111111111111
111111100011000000000000000000000011111111111111111111111
111111111111000000000000000000001111111111111111111111111
111111111111000000001111000000001111111111111111111111111
111111111110000000001111100000001111111111111111111111111
111111111110000000001111100000000111111111111111111000001
111111111110000000001111100000000011111111111111111000001
111111111110000000001111100000000011111111111111111000001
111111111110000000000111100000000011111111111111111000011
111000000011000000000110000000000110001111111111111000011
100000000011000000000000000000000110000011111111111000011
100000000000000011000000000000000000000011111111111000011
000000000000000011000000001110000000000011111111111000011
000000000000000000000000011110000000000011111111111000011
000000000000000000000001111100000000000111111111111100011
100000000000000000000001111000000000000111000011111100011
111000000011111000000000000000000000000110000001111100011
111000000011111000000000000000000000000000000000111000011
111100000011111000000000000000000000000000000000110000000
111100000001111000000000000011000000000000000000000000000
100100000001111000000000000111110000010000000000000000000
000000000000000000001100000111110000011100000000000000000
000000000000000000011100000111110000011111110000000000000
000000000000000000011000000111110000011111110000000000000
000000000000000000000000000111100000000000000001100000000
110000000000000000000000000011000000000000000001100000000
111000000000000000000000000000000000000000000001110000000
111111000000000110000000000000000000000000000001110000000
111111110000001110000000000000000000000000000000110000000
111111110000001100000000000000000000000000000000110000001
111111110000000000000000000000000000000110000000110000001
111111110000000000000000000000000000011110000000000000011
111111110000000000000000000000000000011110000000000000011
111111111000000000000000000000000000011110000000000000111
111111111110000000000011100000000000011110000000000000111
111111111111111100000111111000000111111111000000000111111
111111111111111100000111111111111111111111111111111111111
