-7
7
-7
5
00000000000011
00000000000011
00000000000000
00000000000000
00000000000000
00000000000000
00000000000000
00000000000000
11000000000000
11000000000000
11000000000000
11000022220000
