-7
13
-5
12
11111111122221111111
11111111100001111111
11111110000000111111
11111110000000011111
11111110000000001111
11111000000000000001
11111000000000000000
11110000001110000000
11110000111110000000
11000001111000000000
10000001110000000011
10000000000000111111
00000000000000111111
00000000000001111111
00000000000111111111
11000011111111111111
11222211111111111111
