-7
10
-9
16
11112222111111111
11110000111111111
11100000000011111
11100000000001111
11100000000001111
11000000000000111
10000000000000111
10000000000000111
00000110000000111
00000111000000111
00001111000000111
00001111000000111
00000011000000111
00000000000000011
10000000000000002
11000000000000002
11000000111000002
11000000111000002
11100000011000011
11100000000000011
11110000000000111
11110000000001111
11111000000011111
11111100001111111
11111102201111111
