-16
77
-34
35
111111111111111111111111111111111111111111111111111111111111111111111111111111111111111111111
100000000000000000000000000000011111111111111111111111111111111111111111111111111111111111111
100000000000000000000000000000010000000000000000000000000000000000000000000000000000000000001
100000000000000000000000000000010000000000000000000000000000000000000000000000000000000000001
100000000000000000000000000000010000000000000000000000000000000000000000000000000000000000001
100000000000000000000000000000010000000000000000000000000000000000000000000000000000000000001
100000000000000000000000000000010000000000000000000000000000000000000000000000000000000000001
100000000000000000000000000000010000000000000000000000000000000000000000000000000000000000001
100000000000000000000000000000010000000000000000000000000000000000000000000000000000000000001
100000000000000000000000000000010000000000000000000000000000000000000000000000000000000000001
100000000000000000000000000000000000000000000000000000000000000000000000000000000000000000001
100000000000000000000000000000000000000000000000000000000000000000000000000000000000000000001
100000000000000000000000000000000000000000000000000000000000000000000000000000000000000000001
100000000000000000000000000000000000000000000000000000000000000000000000000000000000000000001
100000000000000000000000000000000000000000000000000000000000000000000000000000000000000000001
100000000000000000000000000000000000000000000000000000000000000000000000000000000000000000001
100000000000000000000000000000010000000000000000000000000000000000000000000000000000000000001
100000000000000000000000000000010000000000000000000000000000000000000000000000000000000000001
100000000000000000000000000000010000000000000000000000000000000000000000000000000000000000001
100000000000000000000000000000010000000000000000000000000000000000000000000000000000000000001
100000000000000000000000000000010000000000000000000000000000000000000000000000000000000000001
100000000000000000000000000000010000000000000000000000000000000000000000000000000000000000001
100000000000000000000000000000010000000000000000000000000000000000000000000000000000000000001
111111111111000000111111111111110000000000000000000000000000000000000000000000000000000000001
100000000000000000000000000000010000000000000000000000000000000000000000000000000000000000001
100000000000000000000000000000010000000000000000000000000000000000000000000000000000000000001
100000000000000000000000000000010000000000000000000000000000000000000000000000000000000000001
100000000000000000000000000000010000000000000000000000000000000000000000000000000000000000001
100000000000000000000000000000010000000000000000000000000000000000000000000000000000000000001
100000000000000000000000000000010000000000000000000000000000000000000000000000000000000000001
100000000000000000000000000000000000000000000000000000000000000000000000000000000000000000001
100000000000000000000000000000000000000000000000000000000000000000000000000000000000000000001
100000000000000000000000000000000000000000000000000000000000000000000000000000000000000000001
100000011111111111100100000000000000000000000000000000000000000000000000000000000000000000001
100000010000010000000100000000000000000000000000000000000000000000000000000000000000000000001
100000010000000000000100000000000000000000000000000000000000000000000000000000000000000000001
100000010110000000000100000000000000000000000000000000000000000000000000000000000000000000001
100000010000000011000100000000000000000000000000000000000000000000000000000000000000000000001
100000010000000000000100000000000000000000000000000000000000000000000000000000000000000000001
100000011000000000000100000000000000000000000000000000000000000000000000000000000000000000001
100000001000000000000100000000000000000000000000000000000000000000000000000000000000000000001
100000001110011111111100000000010000000000000000000000000000000000000000000000000000000000001
100000000000000000000000000000010000000000000000000000000000000000000000000000000000000000001
100000000000000000000000000000010000000000000000000000000000000000000000000000000000000000001
100000000000000000000000000000010000000000000000000000000000000000000000000000000000000000001
100000000000000000000000000000010000000000000000000000000000000000000000000000000000000000001
111111111111112221111111111111110000000000000000000000000000000000000000000000000000000000001
111111111111111111111111111111110000000000000000000000000000000000000000000000000000000000001
111111111111111111111111111111110000000000000000000000000000000000000000000000000000000000001
111111111111111111111111111111110000000000000000000000000000000000000000000000000000000000001
111111111111111111111111111111110000000000000000000000000000000000000000000000000000000000001
111111111111111111111111111111110000000000000000000000000000000000000000000000000000000000001
111111111111111111111111111111110000000000000000000000000000000000000000000000000000000000001
111111111111111111111111111111110000000000000000000000000000000000000000000000000000000000001
111111111111111111111111111111110000000000000000000000000000000000000000000000000000000000001
111111111111111111111111111111110000000000000000000000000000000000000000000000000000000000001
111111111111111111111111111111110000000000000000000000000000000000000000000000000000000000001
111111111111111111111111111111110000000000000000000000000000000000000000000000000000000000001
111111111111111111111111111111110000000000000000000000000000000000000000000000000000000000001
111111111111111111111111111111110000000000000000000000000000000000000000000000000000000000001
111111111111111111111111111111110000000000000000000000000000000000000000000000000000000000001
111111111111111111111111111111110000000000000000000000000000000000000000000000000000000000001
111111111111111111111111111111110000000000000000000000000000000000000000000000000000000000001
111111111111111111111111111111110000000000000000000000000000000000000000000000000000000000001
111111111111111111111111111111110000000000000000000000000000000000000000000000000000000000001
111111111111111111111111111111110000000000000000000000000000000000000000000000000000000000001
111111111111111111111111111111110000000000000000000000000000000000000000000000000000000000001
111111111111111111111111111111111111111111111111111111111111111111111111111111111111111111111
111111111111111111111111111111111111111111111111111111111111111111111111111111111111111111111
