-42
67
-59
24
1111111111111111111111111111111111111111111111111111111111111111111111111111111111111111111111111111111111111
1000000000000000000000000000000111111111111111100000000000000000000000000000000000000000000000000000000000001
1000000000000000000000000000000111111111111111100000000000000000000000000000000000000000000000000000000000001
1000000000000000000000000000000111111111111111100000000000000000000000000000000000000000000000000000000000001
1000000000000000000000000000000111111111111111100000000000000000000000000000000000000000000000000000000000001
1000000000000000000000000000000111111111111111100000000000000000000000000000000000000000000000000000000000001
1000000000000000000000000000000111111111111111100000000000000000000000000000000000000000000000000000000000001
1000000000000000000000000000000111111111111111100000000000000000000000000000000000000000000000000000000000001
1000000000000000000000000000000111111111111111100000000000000000000000000000000000000000000000000000000000001
1000000000000000000000000000000111111111111111100000000000000000000000000000000000000000000000000000000000001
1000000000000000000000000000000111111111111111100000000000000000000000000000000000000000000000000000000000001
1000000000000000000000000000000111111111111111100000000000000000000000000000000000000000000000000000000000001
1000000000000000000000000000000111111111111111100000000000000000000000000000000000000000000000000000000000001
1000000000000000000000000000000111111111111111100000000000000000000000000000000000000000000000000000000000001
1000000000000000000000000000000111111111111111100000000000000000000000000000000000000000000000000000000000001
1000000000000000000000000000000111111111111111100000000000000000000000000000000000000000000000000000000000001
1000000000000000000000000000000111111111111111100000000000000000000000000000000000000000000000000000000000001
1000000000000000000000000000000111111111111111100000000000000000111111111111111111000000000000000000000000001
1000000000000000000000000000000111111111111111100000000000000000111111111111111111000000000000000000000000001
1000000000000000000000000000000111111111111111100000000000000000111111111111111111000000000000000000000000001
1000000000000000000000000000000111111111111111100000000000000000111111111111111111000000000000000000000000001
1000000000000000000000000000000111111111111111100000000000000000111111111111111111000000000000000000000000001
1000000000000000000000000000000111111111111111100000000000000000111111111111111111000000000000000000000000001
1000000000000000000000000000000111111111111111100000000000000000111111111111111111000000000000000000000000001
1000000000000000000000000000000111111111111111100000000000000000111111111111111111000000000000000000000000001
1000000000000000000000000000000111111111111111100000000000000000111111111111111111000000000000000000000000001
1000000000000000000000000000000111111111111111100000000000000000111111111111111111000000000000000000000000001
1000000000000000000000000000000111111111111111100000000000000000111111111111111111000000000000000000000000001
1000000000000000000000000000000111111111111111100000000000000000111111111111111111000000000000000000000000001
1000000000000000000000000000000111111111111111100000000000000000111111111111111111000000000000000000000000001
1000000000000000000000000000000111111111111111100000000000000000111111111111111111000000000000000000000000001
1000000000000000000000000000000111111111111111100000000000000000111111111111111111000000000000000000000000001
1000000000000000000000000000000111111111111111100000000000000000111111111111111111000000000000000000000000001
1000000000000000000000000000000111111111111111100000000000000000111111111111111111000000000000000000000000001
1000000000000000000000000000000111111111111111100000000000000000111111111111111111000000000000000000000000001
2000000000000000000000000000000111111111111111100000000000000000111111111111111111000000000000000000000000002
2000000000000000000000000000000111111111111111100000000000000000111111111111111111000000000000000000000000002
2000000000000000000000000000000111111111111111100000000000000000111111111111111111000000000000000000000000002
2000000000000000000000000000000111111111111111100000000000000000111111111111111111000000000000000000000000002
2000000000000000000000000000000111111111111111100000000000000000111111111111111111000000000000000000000000002
1000000000000000000000000000000111111111111111100000000000000000111111111111111111000000000000000000000000001
1000000000000000000000000000000111111111111111100000000000000000111111111111111111000000000000000000000000001
1000000000000000000000000000000111111111111111100000000000000000111111111111111111000000000000000000000000001
1000000000000000000000000000000111111111111111100000000000000000111111111111111111000000000000000000000000001
1000000000000000000000000000000111111111111111100000000000000000111111111111111111000000000000000000000000001
1000000000000000000000000000000111111111111111100000000000000000111111111111111111000000000000000000000000001
1000000000000000000000000000000111111111111111100000000000000000111111111111111111000000000000000000000000001
1000000000000000000000000000000111111111111111100000000000000000111111111111111111000000000000000000000000001
1000000000000000000000000000000111111111111111100000000000000000111111111111111111000000000000000000000000001
1000000000000000000000000000000111111111111111100000000000000000111111111111111111000000000000000000000000001
1000000000000000000000000000000111111111111111100000000000000000111111111111111111000000000000000000000000001
1000000000000000000000000000000111111111111111100000000000000000111111111111111111000000000000000000000000001
1000000000000000000000000000000111111111111111100000000000000000111111111111111111000000000000000000000000001
1000000000000000000000000000000111111111111111100000000000000000111111111111111111000000000000000000000000001
1000000000000000000000000000000111111111111111100000000000000000111111111111111111000000000000000000000000001
1000000000000000000000000000000111111111111111100000000000000000111111111111111111000000000000000000000000001
1000000000000000000000000000000111111111111111100000000000000000111111111111111111000000000000000000000000001
1000000000000000000000000000000111111111111111100000000000000000111111111111111111000000000000000000000000001
1000000000000000000000000000000000000000000000000000000000000000111111111111111111000000000000000000000000001
1000000000000000000000000000000000000000000000000000000000000000111111111111111111000000000000000000000000001
1000000000000000000000000000000000000000000000000000000000000000111111111111111111000000000000000000000000001
1000000000000000000000000000000000000000000000000000000000000000111111111111111111000000000000000000000000001
1000000000000000000000000000000000000000000000000000000000000000111111111111111111000000000000000000000000001
1000000000000000000000000000000000000000000000000000000000000000111111111111111111000000000000000000000000001
1000000000000000000000000000000000000000000000000000000000000000111111111111111111000000000000000000000000001
1000000000000000000000000000000000000000000000000000000000000000111111111111111111000000000000000000000000001
1000000000000000000000000000000000000000000000000000000000000000111111111111111111000000000000000000000000001
1000000000000000000000000000000000000000000000000000000000000000111111111111111111000000000000000000000000001
1000000000000000000000000000000000000000000000000000000000000000111111111111111111000000000000000000000000001
1000000000000000000000000000000000000000000000000000000000000000111111111111111111000000000000000000000000001
1000000000000000000000000000000000000000000000000000000000000000111111111111111111000000000000000000000000001
1000000000000000000000000000000000000000000000000000000000000000111111111111111111000000000000000000000000001
1000000000000000000000000000000000000000000000000000000000000000111111111111111111000000000000000000000000001
1000000000000000000000000000000000000000000000000000000000000000111111111111111111000000000000000000000000001
1000000000000000000000000000000000000000000000000000000000000000111111111111111111000000000000000000000000001
1000000000000000000000000000000000000000000000000000000000000000111111111111111111000000000000000000000000001
1000000000000000000000000000000000000000000000000000000000000000111111111111111111000000000000000000000000001
1000000000000000000000000000000000000000000000000000000000000000111111111111111111000000000000000000000000001
1000000000000000000000000000000000000000000000000000000000000000111111111111111111000000000000000000000000001
1000000000000000000000000000000000000000000000000000000000000000111111111111111111000000000000000000000000001
1000000000000000000000000000000000000000000000000000000000000000111111111111111111000000000000000000000000001
1000000000000000000000000000000000000000000000000000000000000000111111111111111111000000000000000000000000001
1111111111111111111111111111111111111111111111111111111111111111111111111111111111111111111111111111111111111
