-6
7
-7
5
1110000000000
1110000000000
1110000000000
0000000000000
0000000000000
0000000000000
0000000000000
0000000011111
0000000011111
0000000011111
0000000011111
0022220011111
