-16
16
-12
12
11111111111111111111111111111111
10000000000000000000000000000001
10011111000000000000000000000001
20000000000000000000000000000001
20000000000000000000000000000001
20000000000000000000000000000001
10011111000000000000000000000001
10000000000000000000000000000001
10000000011111100000000000000001
10000000011111100000000000000001
10000000000000000000000000000001
10000000000000111001110000000001
10000000011100101001110000000001
10000000011100111001110000000001
10000000000000000000000000000001
10000000000000000000000000000001
10000000011100011100110000001111
10000000011100011100110000000002
10000000000000000000000000000002
10000000000000000000000000000002
10000000000000000000000000001111
10000000000000000000000000000001
10000000000000000000000000000001
11111111111111111111111111111111
