-5
12
-10
11
11111122221111111
11111100001111111
11100000000001111
11000000000000111
10000000000000011
10000000000000001
00000000000000001
00000000000000000
00000001110000000
00000011111000000
00000011111000000
00000011111000000
00000011110000000
00000000000000000
10000000000000000
10000000000000001
11000000000000001
11100000000000011
11110000000000011
11111110000111111
11111112222111111
