-16
16
-12
12
11111111111111111111111111111111
10000000000000011100000000000001
10000000000000011100000000000001
10000000000000011100000000000001
10000000000000011100000000000001
10000000000000011100000111100001
10000000000000011100000111100001
11111000001111111100000000000001
11111000001111111100000000000001
10000000000000000000000000000001
20000000000000000000000000000002
20000000000000000000000000000002
20000000000000000000000000000002
10000000000000000000000000000001
10000000000000000000000000000001
10000000000000000000000000000001
11111111111110000110000111000001
10000000000010000110000111000001
10000000000010000110000111000001
10000000000010000110000111000001
10000000000000000000000000000001
10000000000000000000000000000001
10000000000000000000000000000001
11111111111111111111111111111111
