-34
48
-25
13
0111111111111111111111111111111111111111111111111111111111111111111111111111111111
1111111111111111111111111111111111111111111111111111111111111111111111111111111111
1111111111111111111111111222221111111111111111111111111111111111111111111111111111
1111111111111111111111111000001111111111111111111111111111111111111111111111111111
1111111111111111111110000000001111111111112222111111111111111111111111111111111111
1111111111111111100000000000001111111100000000001111111111111111111111111111111111
1111111111111111100000000000001111110000000000000000000011111111111111111111111111
1111111111111111000000000000000111100000000000000000000000000111111111111111111111
1111111111110000000000000000000000000000000000000000000000000011111111111111111111
1111111100000000000000000000000000000000000000000000000000000001111111111111111111
1111111000000000000000000000000000000000000000000000001110000001111111111111111111
1111111000000110000000000000000000000000000000000000001110000001111111111111111111
1111111000001111111000000000000000000000000110000000001110000001111111111111111111
1111111000001111111100000000000000000000001111000000000000000001111111111111111111
1111112000000111111111000000011110000000001111000000000000000001111111111111112111
1111112000000111111111000000111111000000001110000000000000000001111111111110000000
1111112000000011111111000000111111100000000000000001111110000000111111111110000000
1111111000000001111111000000111111100000000000000111111111000000111111111110000000
1111111000000001111100000000111111100000000000001111111111111111111111111110000000
1111111000000000111000000000111111110000000000001111111111111111111111111110000000
1111111000000000000000000000000111111000000000001111111111111111111111111110000000
1111111100000000000000000000000011111000000000001111111111111111111111111110000000
1111111111100000000000000000000000000000000000000000000000000000000000000000000000
1111111111111000000000000000000000000000000000000000000000000000000000000000000000
1111111111111111000000000000000000000000000000000000000000000000000000000000000000
1111111111111111111000000000000000000000000000000000000000000000000000000000000000
1111111111111111111111000000000000000000000000000000000000000000000000000000000000
1111111111111111111111111111110000000000000000111111111111111111111111111111111111
1111111111111111111111111111111110000000000000111111111111111111111111111111111111
1111111111111111111111111111111111110000000111111111111111111111111111111111111111
1111111111111111111111111111111111111111111111111111111111111111111111111111111111
1111111111111111111111111111111111111111111111111111111111111111111111111111111111
1111111111111111111111111111111111111111111111111111111111111111111111111111111111
1111111111111111111111111111111111111111111111111111111111111111111111111111111111
1111111111111111111111111111111111111111111111111111111111111111111111111111111111
1111111111111111111111111111111111111111111111111111111111111111111111111111111111
1111111111111111111111111111111111111111111111111111111111111111111111111111111111
1011111111111111111111111111111111111111111111111111111111111111111111111111111111
