-13
46
-58
4
11111111110000000001111100111111111111111111111111111111111
11111111100000000000000000011111111111111111111111111111111
11111111100000110000000000001111111111111111111111111111111
11111111000000110000000000001111111111111111111111111111111
11111111000000000000000000001111111111111111111111111111111
11111112000000000000000000001111111111111111111111111111111
11111112000000000000000000001111111111111111111111111111111
11111112000000000011000000001111111111111111111111111111111
11111112000000000011000100001111111111111111111111111111111
11111111000000000111000110001111111111111111111111111111111
11111111000000000111000110001111111111111111111111111111111
11111111110000001111000010001111111111111111111111111111111
11111111111000001110000000001111111111111111111111111111111
11111111111000001100000000001111111111111111111111111111111
11111111111100000000000000001111111111111111111111111111111
11111111111100000000000000001111111111111111111111111111111
11111111111000000000000000011111111111111111111111111111111
11111111111000000000000000111111111111111111111111111111111
11111111110000000011100000111111111111111111111111111111111
11111111100000000111100000111111111111111111111111111111111
11111111000000000111000000011111001111111111111111111111111
11111111000000000110000000001110001111111111111111111111111
11111111000000000110000000000000000011111111111111111111111
11111111000000000000000000000000000011111111111111111111111
11111111100011000000000000000000000011111111111111111111111
11111111111111000000000000000000001111111111111111111111111
11111111111111000000001111000000001111111111111111111111111
11111111111110000000001111100000001111111111111111111222221
11111111111110000000001111100000000111111111111111111000001
11111111111110000000001111100000000011111111111111111000001
11111111111110000000001111100000000011111111111111111000001
11111111111110000000000111100000000011111111111111111000011
11111000000011000000000110000000000110001111111111111000011
11100000000011000000000000000000000110000011111111111000011
10000000000000000011000000000000000000000011111111111000011
00000000000000000011000000001110000000000011111111111000011
00000000000000000000000000011110000000000011111111111000011
00000000000000000000000001111100000000000111222211111100011
00000000000000000000000001111000000000000111000011111100011
10000000000011111000000000000000000000000110000001111100011
11111000000011111000000000000000000000000000000000111000011
11111100000011111000000000000000000000000000000000110000000
11111100000001111000000000000011000000000000000000000000000
11100100000001111000000000000111110000010000000000000000000
12000000000000000000001100000111110000011100000000000000000
12000000000000000000011100000111110000011111110000000000000
12000000000000000000011000000111110000011111110000000000000
12000000000000000000000000000111100000000000000001100000000
11110000000000000000000000000011000000000000000001100000000
11111000000000000000000000000000000000000000000001110000000
11111111000000000110000000000000000000000000000001110000000
11111111110000001110000000000000000000000000000000110000000
11111111110000001100000000000000000000000000000000110000001
11111111110000000000000000000000000000000110000000110000001
11111111110000000000000000000000000000011110000000000000011
11111111110000000000000000000000000000011110000000000000011
11111111111000000000000000000000000000011110000000000000111
11111111111110000000000011100000000000011110000000000000111
11111111111111111100000111111000000000011111000000000111111
11111111111111111100000111111100000000111111111111111111111
11111111111111111122222111111110000001111111111111111111111
11111111111111111111111111111111000011111111111111111111111
