-16
16
-12
12
11111111111111111111111111111111
10000000000000000000000000000001
10000000000000000000000000000001
10000000000000000000000000000001
10000000000000000000000000000001
10000000000000000000000000000001
10000000000000000000000000000001
10000000000000000000000000000001
10000000000000000000000000000001
10000000000000000000000000000001
10000000111101111011100111100002
10000000000000000000000000000002
10000000111101111011100111100002
10000000111101111011100111100001
10000000000000000000000000000001
10000000000000000000000000000001
10000000000000000000000000000001
10000000000000000000000001111101
10000000000000000000000001000101
10000000000000000000000000000101
10000000000000000000000001000101
10000000000000000000000001111101
10000000000000000000000000000001
11111111111111111111111111111111
