-32
39
-34
23
11111111111111111111111111111111111111111111111111111111111111111111111
11111111111111111111111111111111111111111111111111111111111111111111111
11111111111111111111111111111111111111111111111111111111111111111111111
11111111111111111111111111111111111111111111111111111111111111111111111
11111111111111111111111111111111111111111111111111111111111111111111111
11111111111111111111111111111111111111111111111111111111111111111111111
11111111111111111111111111111111111111111111111111111111111111111111111
11111111111111111111111111111111111111111111111111111111111111111111111
11111111111111111111111111111111111111111111111111111111111111111111111
11111111111111111111111111111111111111111111111111111111111111111111111
11111111111111111111111111111111111111111111111111111111111111111111111
11111111111111111111111111111111111111111111111111111111111111111111111
11111111111111111000000000000000000000000000000111111111111111111111111
11111111111111111000000000000000000000000000000111111111111111111111111
11111111111111111000000000000000000000000000000111111111111111111111111
11111111111111111000000000000000000000000000000111111111111111111111111
11111111111111111000000000000000000000000000000111111111111111111111111
11111111111111111000001111111000000000000111000111111111111111111111111
11111111111111111000001111111000000000000111000111111111111111111111111
11111111111111111000000000000000000000000111000111111111111111111111111
11111111111111111000000000000000000000000111000111111111111111111111111
11111111111111111000000000000000000000000111111111111111111111111111111
11111111111111111000000000000100000000000111111111111111111111111111111
11111111111111111000000000000000000000000111111111111111111111111111111
11111111111111111000000000000000000000000000000111111111111111111111111
11111111111111111000000000000000000000000000000111111111111111111111111
11111111111111111000000000000000000000000000000111111111111111111111111
11111111111111111000001110000000000000000000000111111111111111111111111
11111111111111111000001110000000000000000000000111111111111111111111111
11111111111111111000001110000000000000000000000111111111111111111111111
11111111111111111000000000000000000000000000000111111111111111111111111
11111111111111111000000000000000000000000000000111111111111111111111111
11111111111111111000000000000000000000000000000111111111111111111111111
11111111111111111000000000000000000000000000000111111111111111111111111
11111111111111111111111111111122211111111111111111111111111111111111111
11111111111111111111111111111111111111111111111111111111111111111111111
11111111111111111111111111111111111111111111111111111111111111111111111
11111111111111111111111111111111111111111111111111111111111111111111111
11111111111111111111111111111111111111111111111111111111111111111111111
11111111111111111111111111111111111111111111111111111111111111111111111
11111111111111111111111111111111111111111111111111111111111111111111111
11111111111111111111111111111111111111111111111111111111111111111111111
11111111111111111111111111111111111111111111111111111111111111111111111
11111111111111111111111111111111111111111111111111111111111111111111111
11111111111111111111111111111111111111111111111111111111111111111111111
11111111111111111111111111111111111111111111111111111111111111111111111
11111111111111111111111111111111111111111111111111111111111111111111111
11111111111111111111111111111111111111111111111111111111111111111111111
11111111111111111111111111111111111111111111111111111111111111111111111
11111111111111111111111111111111111111111111111111111111111111111111111
11111111111111111111111111111111111111111111111111111111111111111111111
11111111111111111111111111111111111111111111111111111111111111111111111
11111111111111111111111111111111111111111111111111111111111111111111111
11111111111111111111111111111111111111111111111111111111111111111111111
11111111111111111111111111111111111111111111111111111111111111111111111
11111111111111111111111111111111111111111111111111111111111111111111111
11111111111111111111111111111111111111111111111111111111111111111111111
