-25
34
-20
20
11111111111111000000000001111100000000011111111111111111111
11111111100000000000000002222200000000000111000000000000000
11111111000000000000000000000000000000000000000000000000000
10000000000000000000000000000000000000000000000000000000000
10000000000000000000000000000000000000000000000000000000000
10000000000000000000000000000000000000000000000000000000000
10000000000000000000000000000000000000000000000000000000000
10000000000000000000000000000000000000000000000000000000000
10000000000000000000000000000000000000000000000000000000000
10000000000000000000000000000000000000000000000000000000000
10000000000000000000000000000000000000000000000000000000000
10000000000000000000000000000000000000000000000000000000000
10000000000000000000000000000000000000000000000000000000000
00000000000000000000000000000000000000000000000000000000000
00000000000000000000000000000000000000000000000000000000000
00000000000000000000000000000000000000000000000000000000000
10000000000000000022220000000000002222000000000000000000000
10000000000000000000000000000000000000000000000000000000000
10000000000002000000000000000000000000000000000000000000000
10000000000002000000000000000000000000000000000000000000000
10000000000002000000000000000000000000000000000000000000000
10000000000002000000000000000000000000000000000000000000000
10000000000000000000000000000000000000000000000000000000000
10000000000000000000000000000000000000000000000000000000000
11111111110000000000000000000000000000000000000000000000000
11111111110000000000000000000000000000000000000011111111111
11111111110000000000000001121111000000000000000011111111111
11111111110000000000000001111111000000000000000011111111111
11111111110000000000000011111111000000000000000011111111111
11111111110000000000000011111111000000000000000011111111111
11111111110000000000000011111111000000000000000011111111111
11111111110000000000000011111111000000000000000011111111111
11111111110000000000000011111111000000000000000011111111111
11111111110000000000000011111111000001111110000011111111111
11111111110000000000000011111111000001111110000011111111111
11111111110000000000000011111111000001111110000011111111111
11111111110000000000000011111111000001111110000011111111111
11111111110000000000000011111111000001111110000011111111111
11111111110000000000000011111111000001111110000011111111111
11111111110000000000000011111111000001111110000011111111111
