-8
11
-5
13
1111111111000011111
1111111100000000011
1111110000000000002
1111000000000000002
1110000011000000002
1100000011000000002
1000000000000001111
1000000000000011111
0000011000000011111
0000111100000001111
0000111100000001111
0000011000000011111
0000000000000111111
1000000000001111111
1000000000011111111
1100000000111111111
1110000001111111111
1111222211111111111
