-5
8
-6
6
1000000111111
1000000111111
1000000111111
1000000111111
1000000000002
1000000000002
1000000000002
1000000000002
0000000111111
0000001111111
0000001111111
0000001111111
