-10
11
-3
12
111111111111111111111
111000000000111111111
110000000000011111111
110000000000000001111
100000000000000000111
100000000000000000001
100000000000000000002
100000000000000000002
100000000000000000002
100000000000000000002
100000000000000000001
110000000000000000001
111000000000000011111
111110000001111111111
111111111111111111111
