-38
43
-21
32
111111111111111111111111111111111111111111111111111111111111111111111111111111111
111111111111111111111111111111111111111111111111111111111111111111111111111111111
111111111111111111111111111111111111111111111111111111111111111111111111111111111
111111111111111111111111111111111111111111111111111111111111111111111111111111111
111111111111111111111111111111111111111111111111111111111111111111111111111111111
111111111111111111111111111111111111111111111111111111111111111111111111111111111
111111111111111111111111111111111111111111111111111111111111111111111111111111111
111111111111111111111111111111111111111111111111111111111111111111111111111111111
111111111111111111111111111111111111111111111111111111111111111111111111111111111
111111111111111111111111111111111111111111111111111111111111111111111111111111111
111111111111111111111111111111111111111111111111111111111111111111111111111111111
111111111111111111111111111111111111111111111111111111111111111111111111111111111
111111111111111111111111111000000000001111100000000011111111111111111111111111111
111111111111111111111100000000000000002222200000000000111111111111111111111111111
111111111111111111111000000000000000000000000000000000000111111111111111111111111
111111111111110000000000001111110000000000000001111110000111111111111111111111111
111111111111110000000000001111110000000000000001111110000000000000000000111111111
111111111111110000000000001111110000000000000001111110000000000000000000111111111
111111111111110000000000000000000000000000000000000000000000000000000000111111111
111111111111110000000000000000000000000000000000000000000000000000000000111111111
111111111111110000000000000000000000000000000000000000000000000000000000111111111
111111111111110000000000000000000000000000000000000000000000000000000000111111111
111111111111110000000000000000000000000000000000000000000000000000000000111111111
111111111111110000000000000000000000000000000000000000000011111111111111111111111
111111111111111111111111111100000000000000000000000000000011111111111111111111111
111111111111111111111111111100111111000000000011111100000011111111111111111111111
111111111111111111111111111100111111000000000011111100000011111111111111111111111
111111111111110000000000000000111111000000000011111100000000000000000000111111111
111111111111110000000000000000122221000000000012222100000000000000000000111111111
111111111111110000011111111000000000000000000000000000000000000000000000111111111
111111111111110000011111112000000000000000000000000000000000000000000000111111111
111111111111110000011111112000000000000000000000000000000000000000000000111111111
111111111111110000011111112000000000000000000000000000000000000000000000111111111
111111111111110000011111112000000000000000000000000000000000000000000000111111111
111111111111110000011111111000000000000000000000000000000000000000000000111111111
111111111111110000000000000000000000000000000000000000000000000000000000111111111
111111111111111111111110000000000000000000000000011111100000000000000000111111111
111111111111111111111110000000000000000000000000011111100000011111111111111111111
111111111111111111111110000000000000001121111000011111100000011111111111111111111
111111111111111111111110000000000000001111111000011111100000011111111111111111111
111111111111111111111110000000000000011111111000000000000000011111111111111111111
111111111111111111111110000000000000011111111000000000000000011111111111111111111
111111111111111111111110000000000000011111111000000000000000011111111111111111111
111111111111111111111110000000000000011111111000000000000000011111111111111111111
111111111111111111111110000000000000011111111000000000000000011111111111111111111
111111111111111111111110000000000000011111111000001111110000011111111111111111111
111111111111111111111110000000000000011111111000001111110000011111111111111111111
111111111111111111111110000000000000011111111000001111110000011111111111111111111
111111111111111111111110000000000000011111111000001111110000011111111111111111111
111111111111111111111110000000000000011111111000001111110000011111111111111111111
111111111111111111111110000000000000011111111000001111110000011111111111111111111
111111111111111111111110000000000000011111111000001111110000011111111111111111111
111111111111111111111111111111111111111111111111111111111111111111111111111111111
