-12
16
-13
12
1111111111110111111111111111
1111100000000000000000011111
1111000000000000000011111111
1000000000000000000000000111
1110000000000000000000001111
1111000000000000000000000001
1110000000000000000000001111
1110000000000000000000000011
1100000000000000000000000001
1000000000000000000000000001
1000000000000000000000000001
0000000000000000000000000000
1000000000000000000000000001
1000000000000000000000000001
1000000000000000000000000001
0000000000000000000000000001
0000000000000000000000000111
0000000000000000000000000000
0000000000000000000000000111
1000000000000000000000001111
1100000000000000000000011111
1111100000000000000001111111
1111111100000000000011111111
1111111100000000001111111111
1111111111112222111111111111
