-14
13
-7
7
111111111111111111100011111
111111111122220000000001111
111111111100000000000000111
111111111000000000000000002
111110000000000000000000002
111100000000000000000000002
110000000000000000000000002
200000000000000000000000011
200000000000000000000000011
200000000000000000000000011
200000000000000000000000111
111110000000000000000001111
111111000000000000111111111
111111110000000011111111111
