-42
29
-31
24
11111111111111111111111111111111122222111111111111111111111111111111111
10000000000000000000000000000000000000000000000000000000000000000000001
10000000000000000000000000000000000000000000000000000000000000000000001
10000000000000000000000000000000000000000000000000000000000000000000001
10000000000000000000000000000000000000000000000000000000000000000000001
10000000000000000000000000000000000000000000000000000000000000000000001
11111110111101111011110111101111000000000000000000000000000000000000001
11111110000000000000000000000000000000000000000000000000000000000000001
20000000000000000000000000000000000000000000000000000000000000000000001
20000000000000000000000000000000000000000000000000000000000000000000001
20000000000000000000000000000000000000000000000000000000000000000000001
11111110000000000000000000000000000000000000000000000000000000000000001
11111110000000000000000000000000000000000000000000000000000000000000001
10000000000000000000000000000000000000000000000000000000000000000000001
10000000000000000000000000000000000000000000000000000000000000000000001
10000000000000000000000000000000000000000000000000000000000000000000001
10000000000000000000000000000000000000000000000000000000000000000000001
10000000000000000000000000000000000000000000000000000000000000000000001
10000000000000000000000000000000000000000000000000000000000000000000001
10000000000000000000000000000000000000001111000000000000000000000000001
10000000000000000000000000000000000000001221000000000000000000000000001
10000000000000000000000000000000000000001001000000000000000000000000001
20000000111101111011110111101111011011000000000000000000000000000000002
20000000111101111011110111101111010001000000000000000000000000000000002
20000000000000000000000000000000000000000000000000000000000000000000002
20000000000000000000000000000000010001000000000000000000000000000000002
20000000111101111011110111101111011011000000000000000000000000000000002
10000000000000000000000000000000000000000000000000000000000000000000001
10000000000000000000000000000000000000000000000000000000000000000000001
10000000000000000000000000000000000000000000000000000000000000000000001
10000000000000000000000000000000000000000000000000000000000000000000001
10000000000000000000000000000000000000000000000000000000000000000000001
10000000000000000000000000000000000000000000000000000000000000000000001
10000000000000000000000000000000000000000000000000000000000000000000001
10000000000000000000000000000000000000000000000000000000000000000000001
10000000000000000000000000000000000000000000000000000000000000000000001
10000000000000000000000000000000000000000000000000000000000000000000001
10000000000000000000000000000000000000000000000000000000000000000000001
10000000000000000000000000000000000000000000000000000000000000000000001
10000000000000000000000000000000000000000000000000000000000000000000001
10000000000000000000000000000000000000000000000000000000000000000000001
10000000000000000000000000000000000000000000000000000000000000000000001
10000000000000000000000000000000000000000000000000000000000000000000001
10000000000000000000000000000000000000000000000000000000000000000000001
10000000000000000000000000000000000000000000000000000000000000000000001
10000000000000000000000000000000000000000000000000000000000000000000001
10000000000000000000000000000000000000000000000000000000000000000000001
10000000000000000000000000000000000000000000000000000000000000000000001
10000000000000000000000000000000000000000000000000000000000000000000001
10000000000000000000000000000000000000000000000000000000000000000000001
10000000000000000000000000000000000000000000000000000000000000000000001
10000000000000000000000000000000000000000000000000000000000000000000001
10000000000000000000000000000000000000000000000000000000000000000000001
10000000000000000000000000000000000000000000000000000000000000000000001
11111111111111111111111111111111122222111111111111111111111111111111111
