-11
15
-24
7
11111111111111111110002110
11111111111111111100002110
11111111111111111000002110
11111111111111100000002111
11111111111110000001111111
11111111100000000011111111
11111100000000001111111111
11111000000000011111111111
11110000000001111111111111
11110000011111111111111111
11110000111111111111111111
11110001111111111111111111
11110001111111111111111111
11100000111111111111111111
11100000111111111111111111
11100000001111111111111111
11100000000011111111111111
11110000000011111111111111
11111000000011111111111111
11111000001111111111111111
11111000111111111111111111
11111000111111111111111111
11111000111111111111111111
11111000111111111111111111
11111000111111111111111111
11000000111111111111111111
10000000000000000000211111
10000000000000000000211111
00000000000000000000211111
00000000000011111111111111
10000000111111111111111111
