-6
19
-3
12
1111111111110000000011111
1000001111000000000001111
1000000100000001100000011
2000000000000011100000002
2000000000000011100000002
2000000000000011000000002
2000000110000000000000002
1100001111000000000111111
1100001111000000011111111
1100001111000000011111111
1100000110000001111111111
1100000000001111111111111
1100000000001111111111111
1100000000111111111111111
1110001111111111111111111
