-4
12
-9
10
1122222111111111
1000000001111111
1000000001111111
1000000001111111
1000000011111111
1000000011100011
1000000011000000
1000000010000000
0000000000000000
0000000000000000
0000000000001111
0000000000111111
0000000001111111
0000000011111111
1000000011111111
1000000111111111
1100000111111111
1100000111111111
1122222111111111
